#################
#^      *      !#
#               #
#               #
#               #
#       x       #
#       x       #
#*      x      @#
###x###xx ###x###
#@     1@      @#
#       xx2     #
#       xxx     #
#               #
#               #
#               #
#^      *      @#
#################
